11111111111111111111
100000C00000000000C1
10000111110000000001
100C0000000000111111
10000001000000000001
1001000100C000000001
10000001000000000001
10000000001000001C11
1P0011E00C1000000001
11111111111111111111
