11111111111111
10000000000001
10000000000111
1P00C0000001E1
10000000000111
11111111111111
