1000000001
1P00000001
10E0000001
1111111111
